#################################################
#........#.#..........................#.........#
#........###....##..........##........#.........#
#........#......##..........##........#.........#
#........#............................#.........#
#........#............................#.........#
#........#......##..........##........#.........#
#........#......##..........##........#.........#
#........#..................##........#.........#
#@....B..........B..............................#
#........#..................##........#.........#
#........#......##..........##........#.........#
#........#......##..........##........#.........#
#........#............................#.........#
#........#............................#.........#
#........#......##..........##........#.........#
#........###....##..........##........#.........#
#........#.#..........................#.........#
#################################################